[
  "11111111111111111111111111111111",
  "10001000001000001000000000000001",
  "10001000001010001000000000000001",
  "10111111011011111000000000000001",
  "10000000000010010000000000000001",
  "11111111111010110000000000000001",
  "10000000001000000000000000000001",
  "10000000001011111100000000000001",
  "10000000001010000100000000000001",
  "10000000000010000100000000000001",
  "10000000001010111100000000000001",
  "11111111111000000000000000000001",
  "10000100000011111110000000000001",
  "10000111011110000010000000000001",
  "10000000000000100010000000000001",
  "11111111111111111111111111111111"
]
